111111111111
100000000001
101111110001
100000000001
1001N0000001
111111111111